{
 "tileSize" : 32,
 "widthLevel" : 512,
 "heightLevel" : 512,
 "grid" : 
	[1,1,1,1,1,1,1,1,1,1,1,1,1,1,1,0,
	1,2,2,2,2,2,1,1,1,2,2,2,2,2,1,0,
	1,2,1,2,1,2,2,1,2,2,1,2,1,2,1,0,
	1,2,1,2,1,1,2,1,2,1,1,2,1,2,1,0,
	1,2,1,2,2,1,2,1,2,1,2,2,1,2,1,0,
	1,2,1,1,2,2,2,2,2,2,2,1,1,2,1,0,
	1,2,2,2,2,1,1,2,1,1,2,2,2,2,1,0,
	1,2,1,1,2,1,1,1,1,1,2,1,1,2,1,0,
	1,2,1,2,2,1,2,2,2,1,2,2,1,2,1,0,
	1,2,2,2,1,1,2,1,2,1,1,2,2,2,1,0,
	1,2,1,2,1,2,2,1,2,2,1,2,1,2,1,0,
	1,2,1,2,1,2,1,1,1,2,1,2,1,2,1,0,
	1,2,1,2,2,2,2,2,2,2,2,2,1,2,1,0,
	1,2,1,1,2,1,1,1,1,1,2,1,1,2,1,0,
	1,2,2,2,2,2,2,2,2,2,2,2,2,2,1,0,
	1,1,1,1,1,1,1,1,1,1,1,1,1,1,1,0]
}

